NO ./texture/Castle/C3.xpm
SO ./texture/Castle/C6.xpm
WE ./texture/Castle/C4.xpm
EA ./texture/Castle/C18.xpm
DO ./texture/Doors/HDOR2BB.xpm

F 102,90,59
C 138,111,073

11111111111
1000D0D0001
11111D11111
10000000001
10000N00001
10000000001
11111111111